! language = Japanese
! listname = Genki Elementary
! levelorder = Ascending
! ltype = vocab
! lformat = r_ele, k_ele, meaning

! level = 1
あの		um...
いま	今	now
えいご	英語	English (language)
がくせい	学生	student
〜ご	〜語	language
こうこう	高校	high school
ごご	午後	P.M.
ごぜん	午前	A.M.
〜さい	〜歳	...years old
〜さん		Mr./Ms....
〜じ	〜時	o'clock
〜じん	〜人	people
せんせい	先生	teacher; Professor ...
せんもん	専門	major
そうです		That's right.
だいがく	大学	college; university
でんわ	電話	telephone
ともだち	友達	friend
なまえ	名前	name
なん／なに	何	what
にほん	日本	Japan
〜ねんせい	〜年生	...year student
はい		yes
はん	半	half
ばんごう	番号	number
りゅうがくせい	留学生	international student
わたし	私	I
アメリカ		U.S.A.
イギリス		Britain
オーストラリア		Australia
かんこく	韓国	Korea
スウェーデン		Sweden
ちゅうごく	中国	China
かがく	科学	science
アジアけんきゅう	アジア研究	Asian studies
こくさいかんけい	国際関係	international relations
コンピューター		computer
じんるいがく	人類学	anthropology
せいじ	政治	politics
ビジネス		business
ぶんがく	文学	literature
れきし	歴史	history
しごと	仕事	job; work; occupation
いしゃ	医者	doctor
かいしゃいん	会社員	office worker
こうこうせい	高校生	high school student
しゅふ	主婦	housewife
だいがくいんせい	大学院生	graduate student
だいがくせい	大学生	college student
べんごし	弁護士	lawyer
おかあさん	お母さん	mother
おとうさん	お父さん	father
おねえさん	お姉さん	older sister
おにいさん	お兄さん	older brother
いもうと	妹	younger sister
おとうと	弟	younger brother


! level = 2
これ		this one
それ		that one
あれ		that one (over there)
どれ		which one
この		this ...
その		that ...
あの		that ... (over there)
どの		which ...
あそこ		over there
どこ		where
だれ		who
おいしい		delicious
さかな	魚	fish
とんかつ		pork cutlet
にく	肉	meat
メニュー		menu
やさい	野菜	vegetable
えんぴつ	鉛筆	pencil
かさ	傘	umbrella
かばん		bag
くつ	靴	shoes
さいふ	財布	wallet
ジーンズ		jeans
じしょ	辞書	dictionary
じてんしゃ	自転車	bicycle
しんぶん	新聞	newspaper
テープ		tape
とけい	時計	watch; clock
トレーナー		sweat shirt
ノート		notebook
ペン		pen
ぼうし	帽子	hat; cap
ほん	本	book
おてあらい	お手洗い	restroom
きっさてん	喫茶店	cafe
ぎんこう	銀行	bank
としょかん	図書館	library
ゆうびんきょく	郵便局	post office
けいざい	経済	economics
いくら		how much
〜えん	〜円	...yen
たかい	高い	expensive
いらっしゃいませ		Welcome (to our store)
（〜を）おねがいします		..., please.
（〜を）ください		Please give me...
じゃあ		then...; if that is the case,...
（〜を）どうぞ		Here it is.
どうも		Thank you.


! level = 3
えいが	映画	movie
おんがく	音楽	music
ざっし	雑誌	magazine
スポーツ		sports
デート		date (romantic, not calendar)
テニス		tennis
テレビ		TV
ビデオ		video tape; VCR
あさごはん	朝御飯	breakfast
おさけ	お酒	sake; alcohol
おちゃ	お茶	green tea
コーヒー		coffee
ばんごはん	晩御飯	dinner
ハンバーガー		hamburger
ひるごはん	昼御飯	lunch
みず	水	water
いえ	家	home; house
うち	家	home; house; my place
LL（エルエル）		language lab
がっこう	学校	school
あさ	朝	morning
あした		tomorrow
いつ		when
きょう	今日	today
〜ごろ		at about
こんばん	今晩	tonight
しゅうまつ	週末	weekend
どようび	土曜日	Saturday
にちようび	日曜日	Sunday
まいにち	毎日	every day
まいばん	毎晩	every night
いく	行く	to go
かえる	帰る	to go back; to return
きく	聞く	to listen; to hear
のむ	飲む	to drink
はなす	話す	to speak; to talk
よむ	読む	to read
おきる	起きる	to get up
たべる	食べる	to eat
ねる	寝る	to sleep; to go to sleep
みる	見る	to see; to look at; to watch
くる	来る	to come
する		to do
べんきょうする	勉強する	to study
いい		good
はやい	早い	early
あまり+ negative		not much
ぜんぜん + negative	全然	not at all
たいてい	大抵	usually
ちょっと		a little
ときどき	時々	sometimes
よく		often; much
そうですね		That's right.; Let me see.
でも		but
どうですか		How about...?; How is...?